####################
                   #
#####              #
#         ##       #
#    ###############
#                  #
###########        #
#        ####      #
#  W               #
######          ####
#  F           #####
####################