########################################
                                       #
                                       #
###########                            #
#                                      #
#                                      #
#           ########            ####   #
#                                      #
#                                      #
#                     #####            #
#        ###############################
#                                      #
#                                      #
#                                      #
#############                          #
#         ############                 #
#                  ###########         #
#                                      #
#     W                                #
###########                            #
#                                #######
#                                #######
#     F                     ############
########################################